40 20
100 100
2 2 2 2 2 2 2 2 2 2 2 2 2 2 2 2 2 2 2 2 4 4 4 4 4 4 4 4 4 4 4 4 4 4 4 4 4 4 4 4
2 1 0 0 0 0 0 0 0 0 0 0 0 0 1 0 0 0 1 2 4 0 0 0 0 0 0 0 0 0 0 0 0 0 0 0 0 0 0 4
2 1 0 2 2 2 2 1 1 1 0 0 0 0 1 0 0 0 1 2 4 5 5 5 5 5 5 5 5 5 5 5 5 5 5 5 5 5 5 4
2 1 0 1 1 1 1 1 1 1 1 1 1 1 1 0 0 0 1 2 4 5 5 5 7 7 7 7 7 7 7 5 5 5 5 5 5 5 5 4
2 1 0 1 2 2 2 2 2 2 2 2 2 0 1 0 0 0 1 2 4 5 3 3 3 3 3 3 5 5 5 5 5 5 5 5 5 5 5 4
2 1 0 1 2 2 2 2 1 1 1 1 2 0 1 0 0 0 1 2 4 5 5 5 5 5 5 5 5 5 5 5 5 5 5 5 5 5 5 4
2 1 0 1 1 1 1 1 1 1 1 1 2 0 1 0 0 0 1 2 4 5 5 5 5 5 5 3 3 3 3 3 3 5 5 5 5 5 5 4
2 1 0 1 2 2 2 2 1 2 1 1 2 0 1 0 0 0 1 2 4 5 5 5 1 1 1 1 1 1 1 1 1 1 1 1 1 1 1 4
2 1 0 1 1 1 1 2 1 2 1 1 2 0 1 0 0 0 1 2 4 5 5 5 5 5 5 5 5 5 5 5 5 5 5 5 5 5 5 4
2 1 0 0 0 0 1 2 1 2 1 1 2 0 1 0 0 0 1 0 0 5 5 5 5 5 5 5 5 5 5 5 5 5 5 5 5 5 5 4
2 1 0 0 0 0 1 2 1 2 1 1 2 0 0 0 0 0 1 2 4 5 5 5 5 5 5 5 5 5 5 5 5 5 5 5 5 5 5 4
2 1 0 0 0 0 1 1 1 1 1 1 1 1 1 0 0 0 1 2 4 5 5 5 3 3 3 3 3 3 3 3 3 5 5 5 5 5 5 4
2 1 0 0 0 0 0 0 0 0 0 0 2 0 0 0 0 0 1 2 4 5 5 5 5 5 5 5 5 5 5 5 5 5 5 5 5 5 5 4
2 1 0 0 0 0 2 2 0 2 2 0 0 0 0 0 0 0 1 2 4 5 5 5 5 5 5 5 5 5 5 5 5 5 5 5 5 5 5 4
2 1 0 0 0 2 2 0 0 0 2 2 0 0 0 0 0 0 1 2 4 5 5 5 6 6 6 6 5 5 5 5 5 5 5 5 5 5 5 4
2 1 0 0 2 2 0 0 0 0 0 2 2 0 0 0 0 0 1 2 4 5 5 5 5 5 5 5 6 6 6 6 5 5 5 5 5 5 5 4
2 1 0 2 1 1 1 1 1 1 1 1 1 2 1 1 0 0 1 2 4 5 5 5 5 5 5 5 5 5 5 5 5 5 5 5 5 5 5 4
2 1 0 0 0 0 0 0 0 0 0 0 0 0 0 0 0 0 1 2 4 5 5 5 5 5 5 5 5 5 5 5 5 5 5 5 5 5 5 4
2 1 0 0 0 0 0 0 0 0 0 0 0 0 0 0 0 0 1 2 4 5 5 5 5 5 5 5 5 5 5 5 5 5 5 5 5 5 5 4
2 2 2 2 2 2 2 2 2 2 2 2 2 2 2 2 2 2 2 2 4 4 4 4 4 4 4 4 4 4 4 4 4 4 4 4 4 4 4 4